SO img/Mona_Lisa.xpm
NO img/Wheat_Field.xpm
EA img/the_starry_night.xpm
WE img/girl_with_a_pearl_earring.xpm

CP img/ceiling.xpm
FP img/floor.xpm
C 153,255,255
F 100,100,100

111111111111111111111111111
10000000001100000000000011
10110000011100000000000011
10010000000000001000000011
1111111110110000111000011
1000000000110000011101111111111111111111111111
111101111111010111000000000000000000000000001
1111011110000110111010100111111111111111111111
11110111000001101110101001
11110111000001101110101001
11110111000001101110101001
1111011100S001101110101001
11110111000001101110101001
11110111100001101110101001
11110111100001101110101001
  11000001110101011111010011
   11111111111111111111111111
