NO Mona_Lisa.xpm
SO Wheat_Field.xpm
WE the_starry_night.xpm
EA girl_with_a_pearl_earring.xpm

CP ceiling.xpm
FP floor.xpm
C 153,255,255
F 100,100,100


1111111111
1000000001
1000000001
1000000001
10S0000001
1111111111